hola : salut 
adios : Au-revoir
amigo : ami
amarillo : jaune
rojo : rouge
hombre : homme
mujer : femme
niño : enfant
dia : jour
tarde : après-midi
noche : nuit
feliz : heureux
felicidad bonheur
oscuro : sombre
guerra : guerre
paz : paix
cielo : ciel
nube : nuage
montaña : montagne
rio : rivière
bosque : forêt
desierto : désert
llanura : plaine
amor : amour
odio : Je-déteste
tristeza : tristesse
dolor : douleur
pasion : passion
frustracion : frustation
vida : vie
por : par
inteligente : intelligent