hola : ciao 
adios : addio
amigo : amico
amarillo : giallo
rojo : rosso 
hombre : uomo
mujer : donna
niño : bambino
dia : giorno
tarde : pomeriggio
noche : notte   
feliz : felice
felicidad : felicità
oscuro : scuro
guerra : guerra
paz : pace
cielo : cielo
nube : nuvola
montaña : montagna
rio : rio
bosque : foresta
desierto : deserto
llanura : pianura
amor : amore
odio : odio
tristeza : tristezza
dolor : dolore
pasion : passione
frustracion : frustrazione
vida : vita
por : da
inteligente : intelligente