hola : hello 
adios : bye 
amigo : friend
amarillo : yellow
rojo : red 
hombre : man
mujer : woman
niño : children
dia : day
tardes : afternoon
noche : night
feliz : happy
felicidad happiness
oscuro : dark
guerra : war
paz : peace
cielo : heaven
nube : cloud
montaña : mountain
rio : river
bosque : woods
desierto : desert
llanura : plain
amor : love
odio : hatred
tristeza : sadness
dolor : pain
pasion : passion
frustracion : frustration
vida : life
por : for
inteligente : intelligent